###################
#                 #
################# #
#                 #
#   ####OOO########
#                C#
#            C   M#
###################
